........................................................................................................................
........................................................................................................................
........................................................................................................................
........................................................................................................................
........................................................................................................................
........................................................................................................................
..............................................................................................................................................................................................................................................e1
..............................................................................................................................................................................................................................................e1
..............................................................................................................................................................................................................................................e1
..............................................................................................................................................................................................................................................e1
...............................................................................................................................................................................1..............................................................e1
.............................11111..................................................................................................................1.......1........1111.....................................................................e1
......................s1s...........11..............................................111...................1................................1.................................1.............................1..................................e1
...........s1ss..............................11..........................11.................1.........................................1.............................................................1............1............................e1
.....1s1...........1...................11......................111...................................1............................1.........................................................111............................1       .1................e1
..........................................1...........1......................................................................1.....................................................1............................................1.............e1
11111sssssssssssssssssssssssssssssssssssssssssssssssssssssssssssssssssssssssssssssssssssssssssssssssssssss1111111111111111111sssssssssssssssssssssssssssssssssssssssssssssssssssssssssssssssssssssssssssssssssssssssssssssssssssss11111111111111
111111111111111111111111111111111111111111111111111111111111111111111111111111111111111111111111111111111111111111111111111111111111111111111111111111111111111111111111111111111111111111111111111111111111111111111111111111111111111111111111
111111111111111111111111111111111111111111111111111111111111111111111111111111111111111111111111111111111111111111111111111111111111111111111111111111111111111111111111111111111111111111111111111111111111111111111111111111111111111111111111

